# Source: https://orpa.princeton.edu/export-controls/sanctioned-countries
BA	Bosnia-and-Herzegovina
BI	Burundi
BY	Belarus
CD	Democratic-Republic-of-the-Congo
CF	Central-African-Republic
CG	Republic-of-the-Congo
CI	Ivory-Coast
CN	China
CU	Cuba
CY	Cyprus
ER	Eritrea
ET	Ethiopia
HK	Hong-Kong
HT	Haiti
IQ	Iraq
IR	Iran
KP	North-Korea
LB	Lebanon
LK	Sri-Lanka
LY	Libya
MK	North-Macedonia
MM	Myanmar
NI	Nicaragua
RO	Romania
RU	Russia
SD	Sudan
SO	Somalia
SS	South-Sudan
SY	Syria
UA	Ukraine
VE	Venezuela
VN	Vietnam
XK	Kosovo
YE	Yemen
ZW	Zimbabwe
